111111111111111111111111111111111111111111111111111111111111111111111111111111111
1P0000000000000010100000000000100000000010000010100000000010000000100000100000001
101110101111111010101110111110101111111111101010101010101111101110101111111010111
100010101000000010001000000010000010000000001010101010100010000010001010100010101
101011101010111011111011111011101111101110101110111111101110111010101010101111101
101000101010001000000010100010001000101010100010001010000000101010100010001000001
101110101110101010111010101110101010111010111011101011101111101010101111101011101
101010001010101000000010000000100010100000100000101010001010000010101000101010001
101011111011111111101111111111111011101111101110101011101011111011111010101011101
100000100000101010000000001000001000100010000010000010000010001010100010000010001
101110111110101010101111101011111011101010111111111011101110101010111110111111111
1C0010000000000000101010000000101010001010100000000000001010101000100000000000101
101111101010111011111010111011101010111011101110101110111011101110101111101111101
100010101010101000001000100000001000100010000010101010001000100000101010101000001
101110101110101011111110111010111110101111101110111010111011101110101010101111101
101000001000001000001000001010101000100000100010000010001000000010001010100000001
101111111111101110111111101110101111101111111111101011111110111111101010101010111
101010000010000010000000101010001000000010100000101000001000100000001000101010001
101011101010111011111011111010111011101010101111111111101010111111101011101111111
100010001000101000101000000010000010101010100000000000001010000000101000000010001
101011101110101111101111111111101010101110101111101111111110111011111011101110111
100000101000101000100010001000101010101000100010000010000010101010100000100010001
111010101011101010101110101110101010111010111011111010101010101010111011101010111
101010101010100010001010101010001010100010100000001010101010100010100010101010101
101010111110111011111010111011101010111110111111111111111011111110101110101010101
100010000000100010000000001000101010001010000000101000001000001000000000101010001
101111111110101011101011111110101111101010111111101110101011111011111111111110101
100010000000101000101000000000000000101010100000001000100010000000000000000C00101
101010101110101011111011111111101011101010111111101011101111101111101010111010111
101010100000101010100000100010001000000000001000100000101000100000101010100010001
111010111111101010111011101011101110101010101110101110111110101111101111111110111
100010101010101010101000101000101000101010100010101010101010000010000000000000001
111010101010101010101010101111111110111111111010101011101011111111101111111111101
101000000010001000001010001010001000100000101000001000100010001000001010000010101
1011101110111011101011111010101010101010101011111C1010101010101011111010101010101
100000100010001000100010100000101010001010100000000010101010100010000010101010001
101000001011111111101110101111111110111011111110101110101110101010111110111010111
101010000010000000000010001010000010100000100010001010101000101000000010100010001
1010101C1011101011111010111011101110111110101010111011101111101011101010101011101
1000100010000010001000000000000C0000100000001000000C0C0C00000000000010001010000E1
111111111111111111111111111111111111111111111111111111111111111111111111111111111