11111111111111111111111
1PC0000001NNNNNNNNNNNN1
1NNNNNNN0NNNNNNN1NNN111
1NNN10000001NNNN0000001
1NNNN0NN1N0NNNNN0N0NN01
1NNNN0NNNN0N1NNN0N0NN01
1NNNN0NNNN0N0001010NN01
1NNNN0NNNN0N0N00010NN01
1NNNNNNNNN00011NNN0NN01
1NNNNNNNNN1NNNNNNNNNNE1
11111111111111111111111
