

1111111111111111111
1000000000000000CE1
1000000000000000001
1000P00000000000001
1000000000000000001
1000000000000000001
1000000000000000001
1000000000000000001
1111111111111111111
