111111
100001
1PEC01


100001
100001
111111
