11111111111111111111111
1PCCCCCCCCCCCCCCCC00001
10000000000000000000011
100000000000000000000E1
11111111111111111111111