11111111111
1P101000001
1C101010101
10000000101
10111011101
10000010001
11111010111
10001000001
10111011101
100000100E1
11111111111