1111111111111111111111111111111111111111111111111111111111111111111111111111111111111111111111111111111111111
1P00011111111111111111111111111100011111111110000000000001111111111111111111111111111111111111111111111111111
1111011100000111111111111111111101010001111100111111111101111111111111000011111111111111111111111111111111111
1111011101110111111111111111100001010101111101111111111101111111111111011011111111111111111111111111111111111
1111011101110111111111111111101111000101111101111111111101111111111111011011111100000111111111111111111111111
1110011101110111111111111111101111111101111101111111111101111111111111011011111101110111111111111111111111111
1110111101110111111000011111101111111101111100000001111101111100000000011011111100000111111111111111111111111
1110000001110111111011011111101111111101111111111101111101111101111111111011111111100111111111111111111111111
1111111111110111000011011110001111111101111111111101111101111101111111111011111111100111111111111111111111111
1111111100000111011111011110111111111101111111111101111101111101111111111011111111100111111111111111111111111
1111111101111100011111011110111111111101111111000101111101110001111110000011111111100111111111111111111111111
1111111101100001111111011110111100000001111111010001111101110111111110111111111111100111111111111111111111111
1111111101101111111111011110111101111111111111011111111101110111111110111111111111100111111111111111111111111
1111111101101111111111011110111101111111111111011111111101110111111110111111111111100111111111111111111111111
1111111101101111111111011110111101100000000111011111111101110000001110111111111111100000111111111111111111111
1111111100001111111111011000111101101111110111000111111101111111101110111111111111101110111111111111111111111
1111111111111111111111011011111101101111110111110111111101111111101110111111111111101110111111110000001111111
1110000000000000000000011001111100001111110111110111111101111111101110000000000000001110111111110111101111111
1110111111111111111111111101111111111111110000000111111101111111101111111111111111111110111111110111101111111
1110111111111111111111111101111111111111111111111111111101111111101111111111111111111110111111110111101111111
1110111111111111111111111101111111111111111111111111111101111111101111111111111111111110111110000111100001111
1110111111111111111111111101100000111111111111111111111101111111101111111100000001111110111110111111111101111
1110111111111111111111111101101110111111111111111111111101111111101111111001111101111110111110111111111101111
1110000000000000000000000001101000111110000001111111111101111111101111110011111101111110111110111111111101111
1111111111111111111111111111101011111110111101111111111101100000101111110111111100000000111110111111111101111
1100001111111100000011111111101011111110111101111111111101101110101111110111111111111111111110111111111100011
1101101111111101111000011111101011111110111101111111111101101110001111110111111111111111111110000000111111001
1101100111111101111111011111101011111110111100000000000001101111111111110111111111111111111111111110111111101
1101110111111101111111011111101000000000111111111111111111101111111111110111111111111000000000001110111111101
1101110111111101111111011111101111111111111111100000000000001111111111110111111111111011111111101110111111101
1101110111111101111111000000001111111111111111101111111111111111111111110111111111111011111111101110111111101
1101110000000001111111111111111111111111000000001111111111111111111111110111111111111000000111101110111111101
1101111111111111111111111111111111111111011111111111111111111111111111110111111111111111110111101110111111101
1101111111111111111111111111111111100000011111111111111111111111111111110111111111111111110111101110111111101
1101111111111000011111111111111111101111111111111111111111111111111111110111111111111111110111101110111111101
1100000011000011011111111111111111101111000000001111111110011111111111110111111111111111110111101110111111101
1111111011011111011111111110000111101111011111101111111110011111111111110111111111000000000111101110111111101
1111111011011111011111111110110111101111011111101111111000011111111111110111111111011111111111100000111111101
1111111000011111011111111110110000001111011111101111111011000000011111110111111000011111111111111111111111101
1111111111111111011111111110111111111111011110001111111011111111011111110111111011111111111111111111111111101
1111111111111111011111111110111111000000011110111111111011111111011111110111111011111111111111111111111111101
1111111111111111000000000000111111011111111110111111111011111111000011110111111011111111100000111111111111101
1111111111111111111111111111111111011111111110111111111011111111111011110110000011111111101110111111111111101
1111111110000000111110000001111111011111111110000011111011111111111011110110111111111111101110000000000000001
1111111110111110111110111101100000011111111111111011111011111111111011110110111111111111101111111111111111111
1111111110111110111110111101101111111111111111111011111011111111111000000110111111111111101111111111111111111
1111111110110000111110111100001111111111111111111011111000000000000111111110111111100000001111111111111111111
1111111110110111111110111111111111111111111111111011111111111111110111111110111111101111111111111111100001111
1111111110110111100000111111111111111111111111111000000000011111110111111110111111101111100000011111101101111
1111111110110111101111111111111111111111111111111111111111011111110000000000111111101111101111011111101101111
1111111110110000001111111111111111111111111000011100001111011111111111111111111111101111100011000000001101111
1111111110111111111111111111111111111111111011000001100000011111111111111111111111101111111011111111111101111
1111111110000111111111111111111111111111111000000000000000000000000000000000000000001111111011111111111101111
1111111111110111100000111111111111111111111111111000001111111111111111111111111111111111111011110000111101111
1111111111110000001110111111000000011111111111111011101111111111111111111111111111100000000011110110111101111
1111111111111111111110111111011111011111111111111011101110000111111111111110000000001111111111110110111101111
1111111110000001111110111111011111011111111111000011101110110111100011111110111111111111111111110110000001111
1111111110111101111110111000011111011111111111011111101110110111101011111110000011111111111111110111111111111
1111111110111101111110111011111111011111111111011111100000110111101011111111111011111111111111110111100000111
1111111110111100000000111011111111011111110000011111111111110111101000111111111011111111111111110111001110111
1111111110111111111111111011111111011111110111111111110000000111101110111111000011111111111111110111011110111
1111111110111111111111000011111111000000110111111111110111111111101110111111011111111111111111110000011110111
1110000000111111111111011111111111111110010111111111110000000000001110111111011111111111111111111111111110111
1110000000000000000000011111111111111111000111111111111111111111111110000000011111111111111111111111111110CE1
1111111111111111111111111111111111111111111111111111111111111111111111111111111111111111111111111111111111111