1111111111111111111111111111111111111111111111111111
1110000000000000000000000000000000000000000000000001
1001100000000000000000000000000000000000000000000001
1000011000000000000000000000000000000000000000000001
1000000110000000000000000000000000000000000000000001
1000000001100000000000000000000000000000000000000001
1000000000011000000000000000000000000000000000000001
1000000000000110000000000000000000000000000000000001
1000000000000001100000000000000000000000000000000001
1000000000000000011000000000000000000000000000000001
1000000000000000000110000000000000000000000000000001
1000000000000000000001100000000000000000000000000001
1000000000000000000000011000000000000000000000000001
1000000000000000000000000110000000000000000000000001
1000000000000000000000000001100000000000000000000001
1000000000000000000000000000011000000000000000000001
1000000000000000000000000000000110000000000000000001
1000000000000000000000000000000001100000000000000001
1000000000000000000000000000000000011000000000000001
1000000000000000000000000000000000000110000000000001
1000000000000000000000000000000000000001100000000001
1000000000000000000000000000000000000000011000000001
1000000000000000000000000000000000000000000110000001
1000000000000000000000000000000000000000000001100001
1000000000000000000000000000000000000000000000010001
1CCCCCCCCCCCCCCCCCCCCCCCCCCCCCCCCCCCCCCCCCCCCCCCC0E1
1000000000000000000000000000000000000000000000110001
1000000000000000000000000000000000000000000011000001
1000000000000000000000000000000000000000001100000001
1000000000000000000000000000000000000000110000000001
1000000000000000000000000000000000000011000000000001
1000000000000000000000000000000000001100000000000001
1000000000000000000000000000000000110000000000000001
1000000000000000000000000000000011000000000000000001
1000000000000000000000000000001100000000000000000001
1000000000000000000000000000110000000000000000000001
1000000000000000000000000011000000000000000000000001
1000000000000000000000001100000000000000000000000001
1000000000000000000000110000000000000000000000000001
1000000000000000000011000000000000000000000000000001
1000000000000000001100000000000000000000000000000001
1000000000000000110000000000000000000000000000000001
1000000000000011000000000000000000000000000000000001
1000000000001100000000000000000000000000000000000001
1000000000110000000000000000000000000000000000000001
1000000011000000000000000000000000000000000000000001
1000001100000000000000000000000000000000000000000001
1000110000000000000000000000000000000000000000000001
1C11000000000000000000000000000000000000000000000001
1P10000000000000000000000000000000000000000000000001
1111111111111111111111111111111111111111111111111111